0,0,0,0,0,0
0,1,2,3,6,0
1,0,0,0,0,6
6,0,0,0,0,4
0,6,3,5,4,0
0,0,0,0,0,0
