3,5,6,4,1,2
4,0,0,0,0,5
0,3,4,2,5,0
0,2,5,1,3,0
2,0,0,0,0,1
5,4,1,6,2,3
